
F 181,014,163
C 214,230,240

NO ./imgs/NO.xpm
SO ./imgs/SO.xpm
WE ./imgs/WE.xpm
EA ./imgs/EA.xpm
DO ./imgs/DOOR.xpm
M1 ./imgs/PHANTOM1.xpm
M2 ./imgs/PHANTOM2.xpm
M3 ./imgs/PHANTOM3.xpm
M4 ./imgs/PHANTOM4.xpm

        1111111111111111111111111
        1000000000000000000000001
        1000000000000000000000001
        1000000000000000000000001
111111111000000000000000000000001 
100000000000000000000000001111111
10000000000000000000000000001
10000000000000000000000000001
10000000000000000000000000001
10000000000000000000000000001
10000000000000000000000000001
10000000000000000000000000001
1000000111010001111101111000111
11110111 1110001 100000W00001
11111111 1111111 111111111111