F 181,214,163
C 214,230,240

NO ./imgs/NO.xpm
SO ./imgs/SO.xpm
WE ./imgs/WE.xpm
EA ./imgs/EA.xpm

DO ./imgs/DOOR.xpm

M1 ./imgs/PHANTOM1.xpm
M2 ./imgs/PHANTOM2.xpm
M3 ./imgs/PHANTOM3.xpm
M4 ./imgs/PHANTOM4.xpm

        1111111111111111111111111
        1000000000100000000000001
        1000000000200000000000001
        1000040400100000000000011
111111111000000000100000000000001 
10000000111211111110000000011111111111111111111111111111111111111111111111111111111111111111111111111111111111111111
10000000000000100000000000001100000000000000000000000000011000000000000000000000000000110000000000000000000000000001
10000000000000000000000000001100000000000000000000000000011000000000000000000000000000110000000000000000000000000001
100004000000000N0000000000011100000000000000000000000000011000000000000000000000000000110000000000000000000000000001
10000000000000000000000000002000000000000000000000000000000000000000000000000000000000000000000000000000000000000011
10000000040000000400000000001100000000000000000000000000011000000000000000000000000000110000000000000000000000000001
10000000000000000000000000001100000000000000000000000000011000000000000000000000000000110000000000000000000000000001
10000001110100011111011110001111111111111111111111111111111111111111111111111111111111111111111111111111111111111111
11110111 1110001 102000000001
11111111 1111111 111111111111