F 181,214,163
C 214,230,240

NO ./imgs/NO.xpm
SO ./imgs/SO.xpm
WE ./imgs/WE.xpm
EA ./imgs/EA.xpm








DO ./imgs/DOOR.xpm

M1 ./imgs/PHANTOM1.xpm
M2 ./imgs/PHANTOM2.xpm
M3 ./imgs/PHANTOM3.xpm
M4 ./imgs/PHANTOM4.xpm

1111111111111111111111111111111111111111111111111111111111111111111111111111111111111111111111111111111111111111111111111111
111111111000000000000000001111111111111111000000011111111110S000011111111000000000011111111111111111111000000000000001111111
1111110000000000000000000000000111111111100000001111111111000000011111110000000001111111111111111111000000000000000000001111
1110000000111111111111111110000001111111000000011111111111000000111111100000000010000000011111111000000000111111111000000001
1100000001111111111111111111111111111111000000011111111110004000111111000400000000111100000011110000000000000000000000000111
1000000001111111111111111100000011111111000000011111111100000000111110000000001111111000000111100000011111111111111111111111
1110000000000000000000000000001111111111000000000011110000000000111100000000011111000000001111110000000001111111100000001111
1111110000000000000000000011111111111111100000000000000000110000002000000000000000000011111111111100000000000000000001111111
1111111111111111111111111111111111111111112111111111111111111111111111211111111111111111111111111111111111111111111111111111
1111111111111111111111111111111111110000000000011111111111111111100000000000000000011111111111111111111111111111111111111111 
1111111111111111111111111111111000000000000000000011111111111110000000001111100000000011111111111111111111111111111111111111
1111111111111111111111111110000000001111110000000000001111111100000000011111111100000001111111111111111111111111111111111111
1111111111111111111111111111111111111111111110000000111111111000000000111111111110000000111111111111111111111111111111111111
1111111111111111111111111111111111111000000000000111111111110000000001111111111000000000011111111111111111111111111111111111
1111111111111111111111111110000000011111110000000000011111100000000011111111100000000001111111111111111111111111111111111111
1111111111111111111111111111111000000000000000000001111111000000000111111000000000011111111111111111111111111111111111111111
1111111111111111111111111111111110000000000000000011111110000000000000000000011111111111111111111111111111111111111111111111
1111111111111111111111111111111111111111111111111111111111111111111111111111111111111111111111111111111111111111111111111111
1111111111111111111111111110000000001111110000000000001111111100000000011111111100000001111111111111111111111111111111111111
1111111111111111111111111111111111111111111110000000111111111000000000111111111110000000111111111111111111111111111111111111
1111111111111111111111111111111111111000000000000111111111110000000001111111111000000000011111111111111111111111111111111111
1111111111111111111111111110000000011111110000000000011111100000000011111111100000000001111111111111111111111111111111111111
1111111111111111111111111111111000000000000000000001111111000000000111111000000000011111111111111111111111111111111111111111
1111111111111111111111111111111110000000000000000011111110000000000000000000011111111111111111111111111111111111111111111111
1111111111111111111111111111111111111111111111111111111111111111111111111111111111111111111111111111111111111111111111111111
1111111111111111111111111110000000001111110000000000001111111100000000011111111100000001111111111111111111111111111111111111
1111111111111111111111111111111111111111111110000000111111111000000000111111111110000000111111111111111111111111111111111111
1111111111111111111111111111111111111000000000000111111111110000000001111111111000000000011111111111111111111111111111111111
1111111111111111111111111110000000011111110000000000011111100000000011111111100000000001111111111111111111111111111111111111
1111111111111111111111111111111000000000000000000001111111000000000111111000000000011111111111111111111111111111111111111111
1111111111111111111111111111111110000000000000000011111110000000000000000000011111111111111111111111111111111111111111111111
1111111111111111111111111111111111111111111111111111111111111111111111111111111111111111111111111111111111111111111111111111
1111111111111111111111111110000000001111110000000000001111111100000000011111111100000001111111111111111111111111111111111111
1111111111111111111111111111111111111111111110000000111111111000000000111111111110000000111111111111111111111111111111111111
1111111111111111111111111111111111111000000000000111111111110000000001111111111000000000011111111111111111111111111111111111
1111111111111111111111111110000000011111110000000000011111100000000011111111100000000001111111111111111111111111111111111111
1111111111111111111111111111111000000000000000000001111111000000000111111000000000011111111111111111111111111111111111111111
1111111111111111111111111111111110000000000000000011111110000000000000000000011111111111111111111111111111111111111111111111
1111111111111111111111111111111111111111111111111111111111111111111111111111111111111111111111111111111111111111111111111111
1111111111111111111111111110000000001111110000000000001111111100000000011111111100000001111111111111111111111111111111111111
1111111111111111111111111111111111111111111110000000111111111000000000111111111110000000111111111111111111111111111111111111
1111111111111111111111111111111111111000000000000111111111110000000001111111111000000000011111111111111111111111111111111111
1111111111111111111111111110000000011111110000000000011111100000000011111111100000000001111111111111111111111111111111111111
1111111111111111111111111111111000000000000000000001111111000000000111111000000000011111111111111111111111111111111111111111
1111111111111111111111111111111110000000000000000011111110000000000000000000011111111111111111111111111111111111111111111111
1111111111111111111111111111111111111111111111111111111111111111111111111111111111111111111111111111111111111111111111111111
1111111111111111111111111110000000001111110000000000001111111100000000011111111100000001111111111111111111111111111111111111
1111111111111111111111111111111111111111111110000000111111111000000000111111111110000000111111111111111111111111111111111111
1111111111111111111111111111111111111000000000000111111111110000000001111111111000000000011111111111111111111111111111111111
1111111111111111111111111110000000011111110000000000011111100000000011111111100000000001111111111111111111111111111111111111
1111111111111111111111111111111000000000000000000001111111000000000111111000000000011111111111111111111111111111111111111111
1111111111111111111111111111111110000000000000000011111110000000000000000000011111111111111111111111111111111111111111111111
1111111111111111111111111111111111111111111111111111111111111111111111111111111111111111111111111111111111111111111111111111
1111111111111111111111111110000000001111110000000000001111111100000000011111111100000001111111111111111111111111111111111111
1111111111111111111111111111111111111111111110000000111111111000000000111111111110000000111111111111111111111111111111111111
1111111111111111111111111111111111111000000000000111111111110000000001111111111000000000011111111111111111111111111111111111
1111111111111111111111111110000000011111110000000000011111100000000011111111100000000001111111111111111111111111111111111111
1111111111111111111111111111111000000000000000000001111111000000000111111000000000011111111111111111111111111111111111111111
1111111111111111111111111111111110000000000000000011111110000000000000000000011111111111111111111111111111111111111111111111
1111111111111111111111111111111111111111111111111111111111111111111111111111111111111111111111111111111111111111111111111111
1111111111111111111111111110000000001111110000000000001111111100000000011111111100000001111111111111111111111111111111111111
1111111111111111111111111111111111111111111110000000111111111000000000111111111110000000111111111111111111111111111111111111
1111111111111111111111111111111111111000000000000111111111110000000001111111111000000000011111111111111111111111111111111111
1111111111111111111111111110000000011111110000000000011111100000000011111111100000000001111111111111111111111111111111111111
1111111111111111111111111111111000000000000000000001111111000000000111111000000000011111111111111111111111111111111111111111
1111111111111111111111111111111110000000000000000011111110000000000000000000011111111111111111111111111111111111111111111111
1111111111111111111111111111111111111111111111111111111111111111111111111111111111111111111111111111111111111111111111111111
1111111111111111111111111110000000001111110000000000001111111100000000011111111100000001111111111111111111111111111111111111
1111111111111111111111111111111111111111111110000000111111111000000000111111111110000000111111111111111111111111111111111111
1111111111111111111111111111111111111000000000000111111111110000000001111111111000000000011111111111111111111111111111111111
1111111111111111111111111110000000011111110000000000011111100000000011111111100000000001111111111111111111111111111111111111
1111111111111111111111111111111000000000000000000001111111000000000111111000000000011111111111111111111111111111111111111111
1111111111111111111111111111111110000000000000000011111110000000000000000000011111111111111111111111111111111111111111111111
1111111111111111111111111111111111111111111111111111111111111111111111111111111111111111111111111111111111111111111111111111
1111111111111111111111111110000000001111110000000000001111111100000000011111111100000001111111111111111111111111111111111111
1111111111111111111111111111111111111111111110000000111111111000000000111111111110000000111111111111111111111111111111111111
1111111111111111111111111111111111111000000000000111111111110000000001111111111000000000011111111111111111111111111111111111
1111111111111111111111111110000000011111110000000000011111100000000011111111100000000001111111111111111111111111111111111111
1111111111111111111111111111111000000000000000000001111111000000000111111000000000011111111111111111111111111111111111111111
1111111111111111111111111111111110000000000000000011111110000000000000000000011111111111111111111111111111111111111111111111
1111111111111111111111111111111111111111111111111111111111111111111111111111111111111111111111111111111111111111111111111111
1111111111111111111111111110000000001111110000000000001111111100000000011111111100000001111111111111111111111111111111111111
1111111111111111111111111111111111111111111110000000111111111000000000111111111110000000111111111111111111111111111111111111
1111111111111111111111111111111111111000000000000111111111110000000001111111111000000000011111111111111111111111111111111111
1111111111111111111111111110000000011111110000000000011111100000000011111111100000000001111111111111111111111111111111111111
1111111111111111111111111111111000000000000000000001111111000000000111111000000000011111111111111111111111111111111111111111
1111111111111111111111111111111110000000000000000011111110000000000000000000011111111111111111111111111111111111111111111111
1111111111111111111111111111111111111111111111111111111111111111111111111111111111111111111111111111111111111111111111111111
1111111111111111111111111110000000001111110000000000001111111100000000011111111100000001111111111111111111111111111111111111
1111111111111111111111111111111111111111111110000000111111111000000000111111111110000000111111111111111111111111111111111111
1111111111111111111111111111111111111000000000000111111111110000000001111111111000000000011111111111111111111111111111111111
1111111111111111111111111110000000011111110000000000011111100000000011111111100000000001111111111111111111111111111111111111
1111111111111111111111111111111000000000000000000001111111000000000111111000000000011111111111111111111111111111111111111111
1111111111111111111111111111111110000000000000000011111110000000000000000000011111111111111111111111111111111111111111111111
1111111111111111111111111111111111111111111111111111111111111111111111111111111111111111111111111111111111111111111111111111
1111111111111111111111111110000000001111110000000000001111111100000000011111111100000001111111111111111111111111111111111111
1111111111111111111111111111111111111111111110000000111111111000000000111111111110000000111111111111111111111111111111111111
1111111111111111111111111111111111111000000000000111111111110000000001111111111000000000011111111111111111111111111111111111
1111111111111111111111111110000000011111110000000000011111100000000011111111100000000001111111111111111111111111111111111111
1111111111111111111111111111111000000000000000000001111111000000000111111000000000011111111111111111111111111111111111111111
1111111111111111111111111111111110000000000000000011111110000000000000000000011111111111111111111111111111111111111111111111
1111111111111111111111111111111111111111111111111111111111111111111111111111111111111111111111111111111111111111111111111111
1111111111111111111111111110000000001111110000000000001111111100000000011111111100000001111111111111111111111111111111111111
1111111111111111111111111111111111111111111110000000111111111000000000111111111110000000111111111111111111111111111111111111
1111111111111111111111111111111111111000000000000111111111110000000001111111111000000000011111111111111111111111111111111111
1111111111111111111111111110000000011111110000000000011111100000000011111111100000000001111111111111111111111111111111111111
1111111111111111111111111111111000000000000000000001111111000000000111111000000000011111111111111111111111111111111111111111
1111111111111111111111111111111110000000000000000011111110000000000000000000011111111111111111111111111111111111111111111111
1111111111111111111111111111111111111111111111111111111111111111111111111111111111111111111111111111111111111111111111111111
1111111111111111111111111110000000001111110000000000001111111100000000011111111100000001111111111111111111111111111111111111
1111111111111111111111111111111111111111111110000000111111111000000000111111111110000000111111111111111111111111111111111111
1111111111111111111111111111111111111000000000000111111111110000000001111111111000000000011111111111111111111111111111111111
1111111111111111111111111110000000011111110000000000011111100000000011111111100000000001111111111111111111111111111111111111
1111111111111111111111111111111000000000000000000001111111000000000111111000000000011111111111111111111111111111111111111111
1111111111111111111111111111111110000000000000000011111110000000000000000000011111111111111111111111111111111111111111111111
1111111111111111111111111111111111111111111111111111111111111111111111111111111111111111111111111111111111111111111111111111
1111111111111111111111111110000000001111110000000000001111111100000000011111111100000001111111111111111111111111111111111111
1111111111111111111111111111111111111111111110000000111111111000000000111111111110000000111111111111111111111111111111111111
1111111111111111111111111111111111111000000000000111111111110000000001111111111000000000011111111111111111111111111111111111
1111111111111111111111111110000000011111110000000000011111100000000011111111100000000001111111111111111111111111111111111111
1111111111111111111111111111111000000000000000000001111111000000000111111000000000011111111111111111111111111111111111111111
1111111111111111111111111111111110000000000000000011111110000000000000000000011111111111111111111111111111111111111111111111
1111111111111111111111111111111111111111111111111111111111111111111111111111111111111111111111111111111111111111111111111111
1111111111111111111111111110000000001111110000000000001111111100000000011111111100000001111111111111111111111111111111111111
1111111111111111111111111111111111111111111110000000111111111000000000111111111110000000111111111111111111111111111111111111
1111111111111111111111111111111111111000000000000111111111110000000001111111111000000000011111111111111111111111111111111111
1111111111111111111111111110000000011111110000000000011111100000000011111111100000000001111111111111111111111111111111111111
1111111111111111111111111111111000000000000000000001111111000000000111111000000000011111111111111111111111111111111111111111
1111111111111111111111111111111110000000000000000011111110000000000000000000011111111111111111111111111111111111111111111111
1111111111111111111111111111111111111111111111111111111111111111111111111111111111111111111111111111111111111111111111111111
1111111111111111111111111110000000001111110000000000001111111100000000011111111100000001111111111111111111111111111111111111
1111111111111111111111111111111111111111111110000000111111111000000000111111111110000000111111111111111111111111111111111111
1111111111111111111111111111111111111000000000000111111111110000000001111111111000000000011111111111111111111111111111111111
1111111111111111111111111110000000011111110000000000011111100000000011111111100000000001111111111111111111111111111111111111
1111111111111111111111111111111000000000000000000001111111000000000111111000000000011111111111111111111111111111111111111111
1111111111111111111111111111111110000000000000000011111110000000000000000000011111111111111111111111111111111111111111111111
1111111111111111111111111111111111111111111111111111111111111111111111111111111111111111111111111111111111111111111111111111
1111111111111111111111111110000000001111110000000000001111111100000000011111111100000001111111111111111111111111111111111111
1111111111111111111111111111111111111111111110000000111111111000000000111111111110000000111111111111111111111111111111111111
1111111111111111111111111111111111111000000000000111111111110000000001111111111000000000011111111111111111111111111111111111
1111111111111111111111111110000000011111110000000000011111100000000011111111100000000001111111111111111111111111111111111111
1111111111111111111111111111111000000000000000000001111111000000000111111000000000011111111111111111111111111111111111111111
1111111111111111111111111111111110000000000000000011111110000000000000000000011111111111111111111111111111111111111111111111
1111111111111111111111111111111111111111111111111111111111111111111111111111111111111111111111111111111111111111111111111111