NO ./imgs/NO.xpm
SO ./imgs/SO.xpm
WE ./imgs/WE.xpm
EA ./imgs/EA.xpm

F 181,214,163
C 214,230,240

        1111111111111111111111111
        1000000000110000000000001
        1011000001110000030000001
        1001000000020000000000001
111111111011000001110000000000001
100000000011000001110000001111111
11110111111111011100000000001
11110111111111011101010000001
11000000110101011100000010001
10000000000000001100000010001
10000000000000001101010000001
11000001110101011111211110N0111
11110111 1110101 102011010001
11111111 1111111 111111111111