

WE ./imgs/WE.xpm
F 181,214,255
EA ./imgs/EA.xpm
NO ./imgs/NO.xpm
SO ./imgs/SO.xpm
C 214,230,240






        1111111111111111111111111
        1000000000110000000000001
        101100000111000000W000001
        1001000000000000000000001
111111111011000001110000000000001
100000000011000001110000001111111
11110111111111011100000000001
11110111111111011101010000001
11000000110101011100000010001
10000000000000001100000010001
10000000000000001101010000001
1100000111010101111101111010111
11110111 1110101 101111010001
11111111 1111111 111111111111