NO ./imgs/NO.xpm
SO ./imgs/SO.xpm
WE ./imgs/WE.xpm
EA ./imgs/EA.xpm

F 181,214,163
C 214,230,240

        11111111111111111111111111111111111111111111
        10000000001111101010010101010010000000000001
        10110000011100000000000110101010100101010101
        10010000000000000000000011111111111111111111
111111111011000001110000000000001
1000000000110000011100000000000011111111111111111111
1111011111111101110000000000000100000111111110001111
1111011111111101110101000000000000000000111110000001
1100000011010101110000001000111111110101010000001101
1000000000000000110000000100011111000000001000011111
100000000000000011010100000011111000000000000001
11000001110101011111011110000N0111110000100101111111
11110111 1110101 10111101000111101010101011111
11111111 1111111 11111111111111111111111111111111111