NO ./imgs/NO.xpm
SO ./imgs/SO.xpm
WE ./imgs/WE.xpm
EA ./imgs/EA.xpm

F 181,214,163
C 214,230,240

        1111111111111111111111111
        1000000000110000000000001
        1011000001110000000000001
        1001000000000000000000001
111111111011000001110000000000001
1000000000110000011100000000000000000011
11110111111111011100000000000000000011111
111101111111110111010100000000000000000011111
110000001101010111000000100011111
1000000000000000110000000100011111
100000000000000011010100000011111
1100000111010101111101111000dN011111
11110111 1110101 101111010001111
11111111 1111111 1111111111111111