NO ./imgs/NO.xpm
SO ./imgs/SO.xpm
WE ./imgs/WE.xpm
EA ./imgs/EA.xpm

F 181,214,163
C 214,230,240



1111111111111111111111111111111111111111111111
1000000000000000000000000000000000000000000001
1000000000000000000000000000000000000000000001
1000001111111111100000000000111111111110000001
1000001111111111100000000000111111111110000001
1000001111111111100000000000111111111110000001
1000001111111111100000000000111111111110000001
1000000000000000011111111111000000000000000001
1000000000000000011111111111000000000000000001
1000000000111111111111111111111111110000000001
1000000000111111111111111111111111110000000001
1000000000111111111111N11111111111110000000001
1000000000111111100000000000111111110000000001
1000000000111111100000000000111111110000000001
1000000000111111100000000000111111110000000001
1000000000111111100000000000111111110000000001
1000000000000000000000000000000000000000000001
1111111111111111111111111111111111111111111111